FFFFFFFFFFFFFFFFFFFFFFFFFFFFFFFFFFFFFFFF
FFFFFFFFFFFFFFFFFFFFFFFFFFFFFFFFFFFFFFFF
FFFFFFFFFFFFFFFFFFFFFFFFFFFFFFOOOOOOFFFF
FFFFFFFFFFFFFFFFFFFFFFFFFFFFOOOOOOOOFFFF
FFOOOOFFFFFFFFFFFFFFFFFFFFFFOOOOOOOOFFFF
FFOOOOOOOFFFFFFFFFFFFFFFFFFFOOOOOOOOFFFF
FFOOOOOOOFFFFFFFFFFFFFFFFFFFOOOOOOOOFFFF
FFOOOOOOOFFFFFFFFFFFFFFFFFFFOOWOOOOFFFFF
FFOOOOOOOFFFFFFFHHHFFFFFFFFFWWWWWFFFFFFF
FFOOOOOOOFFFFFHHHHHHFFFFFWWWWWWWWWFFFFFF
FFFFFFFFFFFFFFHHHHHHFFFWWWWWWWWWWWWWFFFF
FFFFFFFFFFFFFHHHHHHHHFFFFFFWWWWWWWFFFFFF
FFFFFFFFFFFFFFHHHHHFFFFFFFFFWWWWWFFFFFFF
FFFFFFFFFFFFFFHHHHHFSFFFFFFFFFWFFFFFFFFF
FFFFFFFFFFFFFFHHHHHHFFFFFFFFFFFFFFFFFFFF
FFFFFOOOOOOFFFFFFHHHHHHFFFFFFFFFFFFFFFFF
FFFFFOOOOOOFFFFFFFHHHFFFFFFFFFFFFFFFFFFF
FFFFFOOOOOOFFFFFFFFFFFFFFFFFFFFFFFFFFFFF
FFFFFOOOOOOFFFFFFWWWWWWWFFFFFFFFFFFFFFFF
RRRRRRRRRRRRRRFFFFFWWWWWWWWWFFFFFFFFFFFF
FFFFFOOOROOFFRFFFFFFFFFFWWWWWFFFFFFFFFFF
FFFFFFFFRFFFFRFFFFFFFFFFWWWWWWWFFFFFFFFF
FFFFFFFFRFFFFRFFFFFFFFFFFFFFOOOOOOOFFFFF
FFFFFFFFRRRRRRFFFFFFFFFFFFFFOOOOOOOFFFFF
FFFFFFFFRFFFFFFFFFFFFFFFFFFFOOOOOOOFFFFF
FFFFFFFFRFFFFFFFHHHHHHHFFFFFOOOOOOOFFFFF
FFFFFFFFRFFFFFFFHHHHEHHFFFFFOOOOOOOFFFFF
FFFFFFWWRWWFFFFFHHHHHHHFFFFFOOOOOOOFFFFF
FFFFFWWWRWWWFFFFHHHHHHHFFFFFOOOOOOOFFFFF
FFFFFFWWRWWFFFFFHHHHHHHFFFFFOOOOOOOFFFFF
FFFFFFFFROOOOOOFHHHHHHHFFFFFOOOOOOOFFFFF
FFFFFFFFROOOOOOFHHHHHHHFFFFFFFFFFFFFFFFF
FFFFFFFFROOOOOOFFFFFFFFFFFFFFFFFFFFFFFFF
FFFFFFFFROOOOOOFFFFFFFFFFFFFFFFFFFFFFFFF
FFFFFFFFROOOOOOFFFFFFFFFFFFFFFFFFFFFFFFF
FFFFFFFFROOOOOOFFFFFFFFFFFFFFFFFFFFFFFFF
FFFFFFFFROOOOOOFFFFFFFFFFFFFFFFFFFFFFFFF
FFFFFFFFRFFFFFFFFFFFFFFFFFFFFFFFFFFFFFFF
FFFFFFFFRFFFFFFFFFFFFFFFFFFFFFFFFFFFFFFF
FFFFFFFFRFFFFFFFFFFFFFFFFFFFFFFFFFFFFFFF
