FFFFFFFFRFFFFFFFFFFFFFFFFFFFFFFFFFFFFFFF
FFFFFFFFRFFFFFFFFFFFFFFFFFFFFFFFFFFFFFFF
FFFFFFFFRFFFFFFFFFFFFFFFFFFFFFFFFFFFFFFF
FOOOOOOFRFFFOOOOOOOOOFFFFFFFFFFFFFFFFFFF
FOOOOOOFRFFFOOOOOOOOOFFFFOOOOOOOOOOOFFFF
FOOOOOOFRFFFOOOOOOOOOFFFFOOOOOOOOOOOFFFF
FOOOOOOFRFFFOOOOOOOOWWWFFOOOOOOOOOOOFFFF
FOOOOOOFRFFFOOOOOOWWWWWWFOOOOOOOOOOOFFFF
FOOOOOOFRFFFOOOOOOOOWWWWWOOOOOOOOOOOFFFF
FOOOOOOFRFFFOOOOOOOOOWWWFOOOOOOOOOOOFFFF
FFFFFFFFRFFFOOOOOOOOOWWFFOOOOOOOOOOOFFFF
FFFFFFFFRFFFOOOOOOOOOFFFFOOOOOOOOOOOFFFF
FFFFFFFFRFFFFFFFFFFFFFFFFFFFFFFFFFFFFFFF
FFFFFFFFRFFFFFFFFFFFSFFFFFFFFFFFFFFFFFFF
FFFFFFFFRFFFFFFFFFFFFFFFFFFFFFFFFFFFFFFF
FFFFFFFFRFFFFFFFFFFFFFFFFFFFFFFFFFFFFFFF
HHWHHHHHRHHHHHHHHHHHHHHHHHHHHHHHHHHHHWHH
HWWWHHHHRHHHHHHHHHHHHHHHHHHHHHHHHHHHWWWH
MWWWMMMHRHHHHMMMMMMMMMMMMHHHHHHMMMMMWWWM
MWWWMMMHRHHMMMMMMMMMMMMMMMMHHHHMMMMMWWWM
WWWWWMMHRHHMMMMMMMMMMMMMWWWWHHHMMMMWWWWW
MWWWMMMHRHHMMMMMMMMMMMMMMMMWHHHMMMMMWWWM
MWWWMMMHRHHMMMMMMMMMMMMMMMMWHHHMMMMMWWWM
MWWWMMMHRHHHHMMMMMMMMMMMMHHWHHHMMMMMWWWM
HHWHHHHHRHHHHHHHHHHHHHHHHHWWWWWWWHHHHWHH
HHHHHHHHRHHHHHHHHHHHHHHHHHWHHHHHWHHHHHHH
FFFFFFFFRFFFFFFFFFFFEFFFWWWFFFFFWFFFFFFF
FFFFFFFFRFFFFFFFFFFFFFFFWOOOOOOOWOOOFFFF
FOOOOOOFRFFFOOOOOOOOOFFFWOOOOOOOWOOOFFFF
FOOOOOOFRFFFOOOOOOOOOWWWWOOOOOOOOOOOFFFF
FOOOOOOFRFFFOOOOOOOOOWWWWOOOOOOOOOOOFFFF
FOOOOOOFRFFFOOOOOOOOOWWWWOOOOOOOOOOOFFFF
FOOOOOOFRFFFOOOOOOOOOWWWWOOOOOOOOOOOFFFF
FOOOOOOFRFFFOOOOOOOOOWWWFOOOOOOOOOOOFFFF
FOOOOOOFRFFFOOOOOOOOOFFFFOOOOOOOOOOOFFFF
FOOOOOOFRFFFOOOOOOOOOFFFFOOOOOOOOOOOFFFF
FOOOOOOFRFFFOOOOOOOOOFFFFFFFFFFFFFFFFFFF
FFFFFFFFRFFFFFFFFFFFFFFFFFFFFFFFFFFFFFFF
FFFFFFFFRFFFFFFFFFFFFFFFFFFFFFFFFFFFFFFF
FFFFFFFFRFFFFFFFFFFFFFFFFFFFFFFFFFFFFFFF
