FFRFFFFFFFFFFFFFFFFFFFFFFFFFFFFFFFFFFFFF
FFRFFOOOOOOOFFFFFFFFFFFFFFFFOOOOOOOOOOOF
FFRFFOOOOOOOFFFFFFFFFFFFFFFFOOOOOWWWWWWF
FFRFFOOOOOOOFFFFFFFFFFFFFFFFOOOOOWWWWWWF
FFRFFOOOOOOOFFFFFFFFFFFFFFFFOOOOOWWWWWWF
FFRRROOOOOOORRRRRRRRSFFFFFFFOOOOOWWWWWWF
FFRFFOOOOOOOFFFFFFFFFFFFFFFFOOOOOWWWWWWF
FFRFFOOOOOOOFFFFFFFFFFFFFFFFOOOOOWWWWWWF
FFRFFFFFFFFFFFFFFFFFFFFFFFFFOOOOOWWWWWWF
FFRFFFFFFFFFFHHHHHHHHHHHHHHHOOOOOOOOOOOF
FFRFFFFFFFFFFHHHHHHHHHHHHHHHOOOOOOOOOOOF
FFRFFFFFFFFFFHHHHHHHHHHHHHHHOOOOOOOOOOOF
FFRFFFFFFFFFFHHHHHHHHHHHHHHHOOOOOOOOOOOF
FFRFFFFFFFFFFHHHHHHHHHHHHHHHFFFFFFFFFFFF
FFRFFFFFFFFFFHHHHHHHHHHHHHHHFFFFFFFFFFFF
MMMMMMMMMMMMMMMMMMMHHMMMMMMMWWWWWWWWWWWW
MMMMMMMMMMMMMMMMMMMHHMMMMMMMWWWWWWWWWWWW
MMMMMMMMMMMMMMMMMMMHHMMMMMMMWWWWWWWWWWWW
MMMMMMMMMMMMMMMMMMMHHMMMMMMMWWWWWWWWWWWW
MMMMMMMMMMMMMMMMMMMHHMMMMMMMWWWWWWWWWWWW
MMMMMMMMMMMMMMMMMMMHHMMMMMMMWWWWWWWWWWWW
MMMMMMMMMMMMMMMMMMMHHMMMMMMMWWWWWWWWWWWW
MMMMMMMMMMMMMMMMMMMHHMMMMMMMWWWWWWWWWWWW
FFRFFFFFFFFFFHHHHHHHHHHHHHHHFFFFFFFFFFFF
FFRFFFFFFFFFFHHHHHHHHHHHHHHHFFFFFFFFFFFF
FFRFFFFFFFFFFHHHHHHHHHHHHHHHOOOOOOOOOFFF
FFRFFFFFFFFFFHHHHHHHHHHHHHHHOOOOOOOOOFFF
WWRFFFFFFFFFFHHHHHHHHHHHHHHHOOOOOOOOOFFF
WWRFFFFFFFFFFHHHHHHHHHHHHHHHOOOOOOOOOFFF
WWRFFFFFFFFFFFFFFFFFFFFFFFFFOOOOWWWWWWWF
WWRFFFFFFFFFFFFFFFFFFFFFFFFFOOOOWWWWWWWF
WWRFFFFFFFFFFFFFFFFFFFFFFFFFOOOOWWWWWWWF
WWRFFFFFFFFFFFFFFFFFFFFFFFFFOOOOWWWWWWWF
WWRFFFFFFFFFFFFFFFFFFFFFFFFFOOOOWWWWWWWF
FFRRRRRRRRRRRRRRRRRREFFFFFFFOOOOWWWWWWWF
FFRFFFFFFFFFFFFFFFFFFFFFFFFFFFFFWWWWWWWF
FFRFFFFFFFFFFFFFFFFFFFFFFFFFFFFFFFFFFFFF
FFRFFFFFFFFFFFFFFFFFFFFFFFFFFFFFFFFFFFFF
FFRFFFFFFFFFFFFFFFFFFFFFFFFFFFFFFFFFFFFF
FFRFFFFFFFFFFFFFFFFFFFFFFFFFFFFFFFFFFFFF
